8 9
. # # . # # # # #
. . . . . # E # .
# . # # . . . . .
# . # # . # . # #
. . . # . # . . #
# # . # . # . # .
# . . # # # . . .
# # . . S # . # .
